==...........
==...........
==...........
==...........
==...........
==...........
==...........
==...........
==...........
==...........
==...........
==...........
==...........
==...........
==...........
==...........
==...c.......
==...........
==...........
==...........
==...X.......
==...m.......
==g..X...c...
==...c.......
==...X.......
==...........
==...........
==...........
==PP.........
==PP.........
==...........
==...........
==...........
==...........
==...........
==...........
==...........
==...........
==PPP........
==PPP........
==g..........
==...........
==...........
==...........
==...........
==...........
==PPPP.......
==PPPP.......
==...........
==...........
==...........
==g..........
==...........
==g..........
==...........
==...........
==...........
==PPPq.......
==PPPq.......
==...........
==...........
==...........
==...........
==...........
==...........
==...........
==...........
==...........
==...........
.............
.............
==...........
==...........
==...........
==...........
==...........
==...........
==...X.......
==...m.......
==...X.......
==.......Xg..
==.......X...
==.......Xg..
==.......X...
==.......X...
==.......X...
.........X...
.........X...
.............
==...........
==...........
==.......X...
==.......X...
==.......X...
==...C...c...
==...........
==g..........
==...........
==g..........
==...........
==...X.......
==...S.......
==...........
==...........
==...........
==...........
==...c.......
==k..........
==...........
==...c...m...
==...........
==...........
==...c.......
==...........
==g..........
==...........
==g..........
==...........
==...X.......
==...........
==...........
==.......X...
==.......X...
==.......X...
==g..........
==...........
==g..........
==...........
==g......X...
==...X...c...
==g..X...c...
==.......X...
==...........
==...........
==]..........
==]].........
==]]]........
==]]]].......
==...........
==...........
==]]]].......
==]]]........
==]].........
==]..........
==...........
==...........
==...........
==...........
==]..........
==]].........
==]]]........
==]]]].......
==]]]].......
.............
.............
==]]]].......
==]]]........
==]].........
==]..........
==...........
==...........
==...........
==...........
==PP.........
==PP.........
==...........
==...........
==...........
==...X.......
==...X.......
==...c.......
==...X.......
==...........
==...........
==g..........
==...........
==g..........
==...........
==...........
==PP.........
==PP.........
==]..........
==]].........
==]]]........
==]]]].......
==]]]]]......
==]]]]]].....
==]]]]]]]....
==]]]]]]]]...
==]]]]]]]]...
==...........
==...........
==...........
==...........
==...........
==...........
==...........
==...........
==]F.........
==...........
==...........
==...........
==...........
==...........
==...........
==...........
==...........
==...........
==...........
==...........
==...........
==...........
==...........
==...........
==...........
==...........
==...........
==...........
==...........
==...........
==...........
==...........
==...........